--------1111111
------111001001
--1111100000011
11100011100001-
10000010000011-
1001000001111--
10010010001----
10111110111----
100100001011---
100110011001111
110000010000001
-10001000001111
-11001111000001
--1000000001111
--1111111111---