-------------------------
-------------------------
-------------------------
-------------------------
-------------------------
-------------------------
-------------------------
--------111111111--------
-------11000000011-------
-------10000#00001-------
-------11000000011-------
--------111000111--------
----------10001----------
----------10001----------
---------1100011---------
---------100x001---------
---------1000001---------
---------1111111---------
-------------------------
-------------------------
-------------------------
-------------------------
-------------------------
-------------------------
-------------------------