111111111111111
100000000000001
100000000000001
100000000000001
100000000000001
100000000000001
100000000010001
100000100111001
100000010010001
100000001010001
100000000000001
100000000000001
100000000000001
100000000000001
111111111111111