-------------------------
--1111111111------111111-
--1000000001111111100001-
--1110000000000000000001-
----11100A00000000000001-
------111100000000000001-
------100000000000111111-
------110000000111100B1--
-------1000000110000001--
-------1000001100000011--
-----11100000000000001---
----110000000000000001---
-1111000000000001100011--
-10000000000000110000D1--
-100C000000000110000001--
-1111111000001100000111--
-------11000011000111----
--------11000000001------
---------11000000011-----
----------10000000011----
----------10000000001----
----------11000x00001----
-----------1100000011----
------------11111111-----
-------------------------