--------1111111
------111001001
--1111100000011
11100011100001-
10000010000011-
1001000000111--
10010000001----
10011110011----
100100110011---
100110011001111
110000010000001
-10001000001111
-11001111000001
--1000000001111
--1111111111---