4,8
-------------------------
--1111111111------111111-
-110A00000011111111000#1-
-11000000000000000000001-
--11111###00000000000001-
------111##0000000000001-
------100000000000000011-
------10000000000000001--
------110000000010000#1--
-----11111000000110B#11--
----110000000000011##1---
--11100000000000001111---
-1100000000000000000011--
-10000001100000000000D1--
-1#0C001100000000000##1--
-1111111#0000000000#111--
-------11#00000000111----
--------11#00000001------
---------11000000011-----
---------1#0000000#11----
---------1100000000#1----
----------11000x00001----
-----------1100000011----
------------11111111-----
-------------------------