4,10
-------------------------
------1111111111111------
----11111111111111111----
---111###000000000#111---
--111#0000000000000#111--
--11000A000000000B00011--
-11100000000000000000111-
-11000000##000##00000011-
-11000000#00000#00000011-
-11000000000000000000011-
-1100C0000000000000D0011-
-11000000000000000000011-
-1100000#0000000#0000#11-
-11#0000##00000##000##11-
-11100000##000##0000#111-
--11000000000000000##11--
--111#0000000000000#111--
---111#000000000000111---
----11110000000001111----
------1111100011111------
----------10001----------
---------1100011---------
---------100x001---------
---------1000001---------
---------1111111---------