4,8
--------111111111--------
-----111100000001111-----
---111000000o000000111---
--11000001111111#000#11--
--10000011-----11000001--
-1100000011---1100000011-
-10000C00011-11000A00001-
-100000q0001110000000001-
1100100000001000000010011
1001110000000000000111001
1001-11#000000000o11-1001
1001--11#0000000011--1001
1001---11000x00011---1001
1001--1100000000011--1001
1001-11000o000q00011-10#1
100111000000000000#1110#1
110#1o0000001000000010011
-10000000001110000000001-
-10000B00011-11000D00001-
-1100000#11---1100000011-
--10000011-----11000001--
--110000011111110000011--
---111#000000000000111---
-----111100000##1111-----
--------111111111--------