4,8
--1111111-------1111111--
--1#0A001-------100D##1--
--1#00001-------10000#1--
--1#000011-----11000001--
--11#000011---11#000011--
---1#000001---1#0000#1---
---11000001---10000011---
----10000011-110000#1----
----11#00001110000011----
-----11000001#000011-----
------1100000000#11------
-------11000000011-------
--------1100x0011--------
-------11#00000#11-------
------11#0000000011------
-----110000010000011-----
----110000#1110000#11----
----10000011-110000#1----
---110000#1---10000011---
---1#000001---10000001---
--11#000011---11#000011--
--10000011-----11#00001--
--1000001-------1#00001--
--100C001-------1##B001--
--1111111-------1111111--