4,8
--------111111111--------
-----111100000001111-----
---1110000000000000111---
--110000011111110000011--
--10000011-----11000001--
-1100000011---1100000011-
-10000C00011-11000A00001-
-10000000001110000000001-
1100100000001000000010011
1001110000000000000111001
1001-110000000000011-1001
1001--1100000000011--1001
1001---11000x00011---1001
1001--1100000000011--1001
1001-110000000000011-1001
1001110000000000000111001
1100100000001000000010011
-10000000001110000000001-
-10000B00011-11000D00001-
-1100000011---1100000011-
--10000011-----11000001--
--110000011111110000011--
---1110000000000000111---
-----111100000001111-----
--------111111111--------