2,8
----111111111111111------
--11100000000000##111----
-11#0A00000000000###11---
-11##000000000000000#1---
--1110000000###0000001---
----111111111#00000001---
------------1100000001---
------------11#0000001---
-----------11##0000#11---
---------111#00000011----
-------1110000000011-----
-----1110000000000#11----
----11#00000x00000#11----
----11#0000000000111-----
-----11#000000#111-------
----110000000111---------
---11#00000011-----------
---1##0000011------------
---1#00000011------------
---1#000000#111111111----
---10000000000000000111--
---100000000000000000#11-
---11##000000#00000B0#11-
----111#000####00000111--
------111111111111111----