2,10
----111111111111111------
--11100000000000##111----
-11#0A00000000000###11---
-11##0000000#000000o#1---
--1110000000###0000001---
----111110000###000001---
--------11q00000000001---
---------1100000000001---
---------11000q0000#11---
--------11q0000000011----
-------110000000000011---
-----1110000000000#11----
----11#00000x000q0#11----
----11#0000000000111-----
---11##000o000#011-------
----1100000000011--------
---11#0000000011---------
---1##0000000o11---------
---1#0000000###11--------
---1#q00000##00011111----
---100000000000000q0111--
---100000000000000000#11-
---11##000000#00000B0#11-
----111#000####00000111--
------111111111111111----