3,10
1111111111111111111111---
1#00B0000000A00000C0011--
10000000000000000000001--
1000001##00o00001#10001--
1o0000###100000#1#10001--
1100001##1100001##100011-
-10000q1##1100011#100001-
-1000001###100001##000011
-110000###110000###1000o1
--1100001#1100001##100001
---100001##000001##100001
---10o00#110000####100001
---1000001000001####00001
--11000000000001##1100001
-1100000000000001###00001
-1q000000#000o001###00001
-11000001##1000011#100001
--100000###100q00##100001
--1100000###000001#1000q1
---1110001##000000#000001
-----110001#0000001000001
------1q00000000000000011
------110000x0000000o111-
-------110000001111111---
--------11111111---------