3,12
1111111111111111111111111
10000000000000000000000o1
10B000o0#0000000#00000C01
100000###0000000###000001
100000#00000000000#q00001
11q00##00000A00000##00011
-1000#0000q0000000o#0001-
-1100o##000000000##00011-
--10000##0000000##00001--
--11000#000000000#00011--
---1000000000000000001---
---110000##000##o00011---
----1000##00000##0001----
----110##0000000##011----
-----1##00000o000##1-----
-----11q000000000011-----
------1000000000001------
------1100000000011------
-------10o00000001-------
-------11000000011-------
--------1000000o1--------
--------110000011--------
---------1000001---------
---------100x001---------
---------1111111---------