3,10
1111111111111111111111111
100000000000A000000000001
10B0000000000000000000C01
1000000000000000000000001
1000000000000000000000001
1100000000000000000000011
-10000000000000000000001-
-11000000000000000000011-
--100000000000000000001--
--110000000000000000011--
---1000000000000000001---
---1100000000000000011---
----10000000000000001----
----11000000000000011----
-----100000000000001-----
-----110000000000011-----
------1000000000001------
------1100000000011------
-------10000000001-------
-------11000000011-------
--------100000001--------
--------110000011--------
---------1000001---------
---------100x001---------
---------1111111---------