1,20
----------11111----------
---------110A011---------
---------1000001---------
--------110000011--------
--------100000001--------
-------11000000011-------
-------10000000001-------
------1100000000011------
------1000000000001------
-----110000000000011-----
-----100000000000001-----
----11000000000000011----
----10000000000000001----
---1100000000000000011---
---1000000000000000001---
--110000000000000000011--
--100000000000000000001--
-11000000000000000000011-
--110000000000000000011--
---1100000000000000011---
----11100000000000111----
------1111000001111------
---------1000001---------
---------100x001---------
---------1111111---------