3,0
1111111111111111111111111
10000001A1B1C100000000001
1000000101010100000000001
1000000101010100000000001
1000000101010100000000001
1000000101010100000000001
1000000101010100000000001
1000000101010100000000001
1000000101010100000000001
1000000101010100000000001
1000000101010100000000001
1000000101010100000000001
1000000101010100000000001
1000000101010100000000001
1000000101010100000000001
1000000101010100000000001
1000000101010100000000001
1000000101010100000000001
1000000101010100000000001
1000000101010100000000001
1000000101010100000000001
1000000101010100000000001
1000000101010100000000001
1000000000x00000000000001
1111111111111111111111111