1,0
1111111111111111111111111
1.......................1
1.000000000A00000000000.1
1.000000000000000000000.1
1.000000000000000000000.1
1.000000000000000000000.1
1.000000000000000000000.1
1.000000000000000000000.1
1.000000000000000000000.1
1.000000000000000000000.1
1..........000000000000.1
1111111111.000000000000.1
1..........000000000000.1
1.000000000000000000000.1
1.000000000000000000000.1
1.000000000000000000000.1
1.000000000000000000000.1
1.000000000000000000000.1
1.000000000000000000000.1
1.000000000000000000000.1
1.000000000000000000000.1
1.000000000000000000000.1
1.0000000000x0000000000.1
1.......................1
1111111111111111111111111